{
    "tiles" : [ [1, 1, 1, 1, 1, 1, 1, 1, 1 ],
                [1, 1, 1, 1, 1, 1, 1, 1, 1 ],
                [1, 1, 1, 1, 1, 1, 1, 1, 1 ],
                [1, 1, 1, 1, 1, 1, 1, 1, 1 ],
                [1, 1, 1, 1, 1, 1, 1, 1, 1 ],
                [1, 1, 1, 1, 1, 1, 1, 1, 1 ],
                [1, 1, 1, 1, 1, 1, 1, 1, 1 ],
                [1, 1, 1, 1, 1, 1, 1, 1, 1 ],
                [1, 1, 1, 1, 1, 1, 1, 1, 1 ] ],
    
    "targetScore" : 10000,
    "moves" : 100,
    "beginLevelCookies" : [ [1, 2, 1, 2, 1, 2, 1, 2, 1 ],
                            [2, 1, 2, 1, 2, 1, 2, 1, 2 ],
                            [3, 4, 3, 4, 3, 4, 3, 4, 3 ],
                            [4, 3, 4, 3, 4, 3, 4, 3, 4 ],
                            [1, 2, 1, 2, 1, 2, 1, 2, 1 ],
                            [4, 3, 4, 3, 4, 3, 4, 3, 4 ],
                            [3, 4, 3, 4, 3, 4, 3, 4, 3 ],
                            [2, 1, 2, 1, 2, 1, 2, 1, 2 ],
                            [1, 2, 1, 2, 1, 2, 1, 2, 1 ] ],
}
