{
    "tiles" : [ [0, 0, 0, 0, 0, 0, 0, 0, 0 ],
               [0, 0, 1, 1, 1, 1, 1, 0, 0 ],
               [0, 0, 1, 1, 1, 1, 1, 0, 0 ],
               [0, 0, 1, 1, 1, 1, 1, 0, 0 ],
               [0, 0, 1, 1, 1, 1, 1, 0, 0 ],
               [0, 0, 1, 1, 1, 1, 1, 0, 0 ],
               [0, 0, 1, 1, 1, 1, 1, 0, 0 ],
               [0, 0, 1, 1, 1, 1, 1, 0, 0 ],
               [0, 0, 0, 0, 0, 0, 0, 0, 0 ] ],
    
    "targetScore" : 10000,
    "moves" : 100,
    "beginLevelCookies" : [ [0, 0, 0, 0, 0, 0, 0, 0, 0 ],
                         [0, 0, 1, 2, 1, 2, 1, 0, 0 ],
                         [0, 0, 2, 1, 5, 1, 2, 0, 0 ],
                         [0, 0, 1, 2, 5, 2, 1, 0, 0 ],
                         [0, 0, 5, 5, 3, 5, 3, 0, 0 ],
                         [0, 0, 1, 2, 5, 2, 1, 0, 0 ],
                         [0, 0, 2, 1, 2, 1, 2, 0, 0 ],
                         [0, 0, 1, 2, 1, 2, 1, 0, 0 ],
                         [0, 0, 0, 0, 0, 0, 0, 0, 0 ] ],
}
