{
    "tiles" : [ [1, 1, 1, 1, 1, 1, 1, 1, 1 ],
               [1, 1, 1, 1, 1, 1, 1, 1, 1 ],
               [1, 1, 1, 1, 1, 1, 1, 1, 1 ],
               [1, 1, 1, 1, 1, 1, 1, 1, 1 ],
               [1, 1, 1, 1, 1, 1, 1, 1, 1 ],
               [1, 1, 1, 1, 1, 1, 1, 1, 1 ],
               [1, 1, 1, 1, 1, 1, 1, 1, 1 ],
               [1, 1, 1, 1, 1, 1, 1, 1, 1 ],
               [1, 1, 1, 1, 1, 1, 1, 1, 1 ] ],
    
    "targetScore" : 10000,
    "moves" : 100,
    "beginLevelCookies" : [ [1, 2, 3, 4, 5, 6, 1, 2, 3 ],
                         [6, 5, 4, 3, 2, 1, 6, 5, 4 ],
                         [1, 2, 3, 4, 5, 6, 1, 2, 3 ],
                         [6, 5, 4, 3, 2, 1, 6, 5, 4 ],
                         [1, 2, 3, 4, 5, 6, 1, 2, 3 ],
                         [6, 5, 4, 3, 2, 1, 6, 5, 4 ],
                         [1, 2, 3, 4, 5, 6, 1, 2, 3 ],
                         [6, 5, 4, 3, 2, 1, 6, 5, 4 ],
                         [1, 2, 3, 4, 5, 6, 1, 2, 3 ] ],
}
